"filename", "language", "JSON", "YAML", "Python", "Markdown", "pip requirements", "comment", "blank", "total"
"/home/jesse/code/blessed-rl/blessed-rl/README.md", "Markdown", 0, 0, 0, 119, 0, 0, 40, 159
"/home/jesse/code/blessed-rl/blessed-rl/components/__init__.py", "Python", 0, 0, 22, 0, 0, 3, 3, 28
"/home/jesse/code/blessed-rl/blessed-rl/components/ai.py", "Python", 0, 0, 15, 0, 0, 5, 7, 27
"/home/jesse/code/blessed-rl/blessed-rl/components/character.py", "Python", 0, 0, 51, 0, 0, 13, 26, 90
"/home/jesse/code/blessed-rl/blessed-rl/components/combat.py", "Python", 0, 0, 26, 0, 0, 11, 14, 51
"/home/jesse/code/blessed-rl/blessed-rl/components/core.py", "Python", 0, 0, 23, 0, 0, 10, 21, 54
"/home/jesse/code/blessed-rl/blessed-rl/components/corpse.py", "Python", 0, 0, 7, 0, 0, 5, 8, 20
"/home/jesse/code/blessed-rl/blessed-rl/components/dead.py", "Python", 0, 0, 4, 0, 0, 4, 5, 13
"/home/jesse/code/blessed-rl/blessed-rl/components/effects.py", "Python", 0, 0, 61, 0, 0, 20, 27, 108
"/home/jesse/code/blessed-rl/blessed-rl/components/items.py", "Python", 0, 0, 79, 0, 0, 17, 33, 129
"/home/jesse/code/blessed-rl/blessed-rl/components/skills.py", "Python", 0, 0, 18, 0, 0, 8, 9, 35
"/home/jesse/code/blessed-rl/blessed-rl/components/throwing.py", "Python", 0, 0, 22, 0, 0, 7, 10, 39
"/home/jesse/code/blessed-rl/blessed-rl/data/corpses.json", "JSON", 10, 0, 0, 0, 0, 0, 1, 11
"/home/jesse/code/blessed-rl/blessed-rl/data/enemies.json", "JSON", 62, 0, 0, 0, 0, 0, 1, 63
"/home/jesse/code/blessed-rl/blessed-rl/data/glyphs.json", "JSON", 28, 0, 0, 0, 0, 0, 1, 29
"/home/jesse/code/blessed-rl/blessed-rl/data/items.yaml", "YAML", 0, 144, 0, 0, 0, 7, 13, 164
"/home/jesse/code/blessed-rl/blessed-rl/data/prefabs.yaml", "YAML", 0, 38, 0, 0, 0, 13, 4, 55
"/home/jesse/code/blessed-rl/blessed-rl/data/schedule.yaml", "YAML", 0, 33, 0, 0, 0, 2, 6, 41
"/home/jesse/code/blessed-rl/blessed-rl/ecs/__init__.py", "Python", 0, 0, 5, 0, 0, 3, 3, 11
"/home/jesse/code/blessed-rl/blessed-rl/ecs/component.py", "Python", 0, 0, 37, 0, 0, 17, 19, 73
"/home/jesse/code/blessed-rl/blessed-rl/ecs/entity.py", "Python", 0, 0, 24, 0, 0, 11, 11, 46
"/home/jesse/code/blessed-rl/blessed-rl/ecs/system.py", "Python", 0, 0, 28, 0, 0, 11, 15, 54
"/home/jesse/code/blessed-rl/blessed-rl/ecs/world.py", "Python", 0, 0, 33, 0, 0, 14, 16, 63
"/home/jesse/code/blessed-rl/blessed-rl/effects/__init__.py", "Python", 0, 0, 14, 0, 0, 8, 3, 25
"/home/jesse/code/blessed-rl/blessed-rl/effects/core.py", "Python", 0, 0, 29, 0, 0, 10, 15, 54
"/home/jesse/code/blessed-rl/blessed-rl/effects/implementations/__init__.py", "Python", 0, 0, 8, 0, 0, 3, 3, 14
"/home/jesse/code/blessed-rl/blessed-rl/effects/implementations/blood_splatter.py", "Python", 0, 0, 14, 0, 0, 24, 7, 45
"/home/jesse/code/blessed-rl/blessed-rl/effects/implementations/knockback.py", "Python", 0, 0, 3, 0, 0, 4, 3, 10
"/home/jesse/code/blessed-rl/blessed-rl/effects/implementations/shockwave.py", "Python", 0, 0, 3, 0, 0, 4, 3, 10
"/home/jesse/code/blessed-rl/blessed-rl/effects/physics.py", "Python", 0, 0, 140, 0, 0, 41, 50, 231
"/home/jesse/code/blessed-rl/blessed-rl/effects/status_effects.py", "Python", 0, 0, 82, 0, 0, 19, 31, 132
"/home/jesse/code/blessed-rl/blessed-rl/effects/tile_effects.py", "Python", 0, 0, 73, 0, 0, 18, 26, 117
"/home/jesse/code/blessed-rl/blessed-rl/game/__init__.py", "Python", 0, 0, 4, 0, 0, 3, 3, 10
"/home/jesse/code/blessed-rl/blessed-rl/game/camera.py", "Python", 0, 0, 33, 0, 0, 12, 14, 59
"/home/jesse/code/blessed-rl/blessed-rl/game/character_stats.py", "Python", 0, 0, 70, 0, 0, 20, 35, 125
"/home/jesse/code/blessed-rl/blessed-rl/game/config.py", "Python", 0, 0, 31, 0, 0, 15, 14, 60
"/home/jesse/code/blessed-rl/blessed-rl/game/game_state.py", "Python", 0, 0, 56, 0, 0, 19, 21, 96
"/home/jesse/code/blessed-rl/blessed-rl/game/glyph_config.py", "Python", 0, 0, 65, 0, 0, 30, 19, 114
"/home/jesse/code/blessed-rl/blessed-rl/game/item_factory.py", "Python", 0, 0, 96, 0, 0, 22, 27, 145
"/home/jesse/code/blessed-rl/blessed-rl/game/message_log.py", "Python", 0, 0, 73, 0, 0, 24, 29, 126
"/home/jesse/code/blessed-rl/blessed-rl/game/prefabs/__init__.py", "Python", 0, 0, 4, 0, 0, 3, 3, 10
"/home/jesse/code/blessed-rl/blessed-rl/game/prefabs/loader.py", "Python", 0, 0, 74, 0, 0, 14, 23, 111
"/home/jesse/code/blessed-rl/blessed-rl/game/prefabs/manager.py", "Python", 0, 0, 50, 0, 0, 17, 19, 86
"/home/jesse/code/blessed-rl/blessed-rl/game/prefabs/spawner.py", "Python", 0, 0, 125, 0, 0, 37, 47, 209
"/home/jesse/code/blessed-rl/blessed-rl/game/world_gen.py", "Python", 0, 0, 29, 0, 0, 16, 16, 61
"/home/jesse/code/blessed-rl/blessed-rl/game/worldgen/__init__.py", "Python", 0, 0, 4, 0, 0, 9, 3, 16
"/home/jesse/code/blessed-rl/blessed-rl/game/worldgen/biomes.py", "Python", 0, 0, 173, 0, 0, 45, 76, 294
"/home/jesse/code/blessed-rl/blessed-rl/game/worldgen/core.py", "Python", 0, 0, 213, 0, 0, 50, 62, 325
"/home/jesse/code/blessed-rl/blessed-rl/game/worldgen/scheduler.py", "Python", 0, 0, 169, 0, 0, 30, 49, 248
"/home/jesse/code/blessed-rl/blessed-rl/main.py", "Python", 0, 0, 392, 0, 0, 111, 115, 618
"/home/jesse/code/blessed-rl/blessed-rl/rendering/__init__.py", "Python", 0, 0, 0, 0, 0, 1, 1, 2
"/home/jesse/code/blessed-rl/blessed-rl/rendering/entity_renderer.py", "Python", 0, 0, 62, 0, 0, 22, 17, 101
"/home/jesse/code/blessed-rl/blessed-rl/rendering/tile_renderer.py", "Python", 0, 0, 89, 0, 0, 37, 24, 150
"/home/jesse/code/blessed-rl/blessed-rl/requirements.txt", "pip requirements", 0, 0, 0, 0, 2, 0, 1, 3
"/home/jesse/code/blessed-rl/blessed-rl/systems/__init__.py", "Python", 0, 0, 10, 0, 0, 3, 3, 16
"/home/jesse/code/blessed-rl/blessed-rl/systems/ai.py", "Python", 0, 0, 139, 0, 0, 39, 37, 215
"/home/jesse/code/blessed-rl/blessed-rl/systems/combat.py", "Python", 0, 0, 172, 0, 0, 51, 67, 290
"/home/jesse/code/blessed-rl/blessed-rl/systems/combat_helpers.py", "Python", 0, 0, 174, 0, 0, 37, 58, 269
"/home/jesse/code/blessed-rl/blessed-rl/systems/fov.py", "Python", 0, 0, 134, 0, 0, 35, 36, 205
"/home/jesse/code/blessed-rl/blessed-rl/systems/input.py", "Python", 0, 0, 207, 0, 0, 45, 41, 293
"/home/jesse/code/blessed-rl/blessed-rl/systems/inventory.py", "Python", 0, 0, 189, 0, 0, 46, 66, 301
"/home/jesse/code/blessed-rl/blessed-rl/systems/menu.py", "Python", 0, 0, 111, 0, 0, 30, 37, 178
"/home/jesse/code/blessed-rl/blessed-rl/systems/menus/__init__.py", "Python", 0, 0, 0, 0, 0, 1, 1, 2
"/home/jesse/code/blessed-rl/blessed-rl/systems/menus/drop_menu.py", "Python", 0, 0, 27, 0, 0, 7, 11, 45
"/home/jesse/code/blessed-rl/blessed-rl/systems/menus/equip_menu.py", "Python", 0, 0, 29, 0, 0, 5, 12, 46
"/home/jesse/code/blessed-rl/blessed-rl/systems/menus/inventory_menu.py", "Python", 0, 0, 41, 0, 0, 10, 16, 67
"/home/jesse/code/blessed-rl/blessed-rl/systems/menus/throwing_menu.py", "Python", 0, 0, 52, 0, 0, 9, 19, 80
"/home/jesse/code/blessed-rl/blessed-rl/systems/menus/use_menu.py", "Python", 0, 0, 22, 0, 0, 4, 11, 37
"/home/jesse/code/blessed-rl/blessed-rl/systems/movement.py", "Python", 0, 0, 114, 0, 0, 29, 46, 189
"/home/jesse/code/blessed-rl/blessed-rl/systems/render.py", "Python", 0, 0, 141, 0, 0, 48, 40, 229
"/home/jesse/code/blessed-rl/blessed-rl/systems/skills.py", "Python", 0, 0, 52, 0, 0, 29, 26, 107
"/home/jesse/code/blessed-rl/blessed-rl/systems/throwing.py", "Python", 0, 0, 206, 0, 0, 48, 70, 324
"/home/jesse/code/blessed-rl/blessed-rl/ui/__init__.py", "Python", 0, 0, 0, 0, 0, 1, 1, 2
"/home/jesse/code/blessed-rl/blessed-rl/ui/status_display.py", "Python", 0, 0, 156, 0, 0, 47, 34, 237
"/home/jesse/code/blessed-rl/blessed-rl/ui/text_formatter.py", "Python", 0, 0, 64, 0, 0, 18, 18, 100
"/home/jesse/code/blessed-rl/blessed-rl/utils/__init__.py", "Python", 0, 0, 0, 0, 0, 3, 1, 4
"/home/jesse/code/blessed-rl/blessed-rl/utils/line_drawing.py", "Python", 0, 0, 31, 0, 0, 16, 21, 68
"Total", "-", 100, 215, 4704, 119, 2, 1410, 1724, 8274